************************
********             *****
****     *****   ****   **
***********    ******
   ********** ******  ***
********* ********  *****
************************