********************
********     ****
****       *****   *
***********    *****
   ********** *  ***
************  *****
********************
