********************
*******      *******
*****          *****
***              ***
***              ***
*****          *****
*******      *******
********************